00233411223344411002
11334444332211004321
44321110002222334432
00330011444433210000
00223311122234444332
34444444100011233410
22331100234411133344
00033444443322222233
11122334444100022322
44321111004321100044
22331134444433222211
10000211111233444110
34433222222334444433
00111100011122221100
22233443333311110011
00442211111000044322
33334441122233334411
22110000111122234444
34444444111000022344
11110000111234444321