001334412
320001443
443332000
110444223
231003310
014333121
122000033
331144220
000113344