034040321
030044333
030241432
043424132
224143204
300233000
100430300
424412204
314421410
